11111111111
10P11111111
10000PC0E11
11111111111