1111111111111
1C01CP00000C1
10CC011111001
1C0C11E00C001
1111111111111