11111111111
10P11111111
100000C0E11
11111111111