1111111111111
1C0CCP00CC0C1
10CC111111101
1C0C11E000001
1111111111111
