11111111111
10PCCCCCCC1
100000C0E11
11111111111