1111111111111111
1C0CCP00CC0C0001
10CC111111100001
1C0C11E000000001
1111111111111111