1111111
1P0CCC1
11CC1E1
1111111