1111111
1P00CC1
11CC101
1111111