1111111
1P00CC1
11CC1E1
1111111